BUSHIDO ZHO - vodila
Arut - VLAGA
Шайни - Yeyo!
Poshlaya Molly - Нон стоп
The Limba - Известным
shadowraze - astral step
j-hope - MORE
INSTASAMKA - RARARA
Kate Bush - Running Up That Hill (A Deal With God)
kizaru - Elon Musk
PLAYAMANE - MIDNIGHT
xxxmanera - Never Broke Again
Кореш - глаза не врут
Scally Milano - Я хочу тебя трахать
Dxrk ダーク - RAVE
10AGE - Ау
Big Baby Tape - Million
pyrokinesis - Днями-ночами
Kordhell - Murder In My Mind
Mr.Kitty - After Dark
FACE - ЛАБИРИНТ
Max Korzh - Это наш путь
WENARO - Лёд
КАКАЯ РАЗНИЦА - Рассвет
MoonDeity - NEON BLADE
uniqe - ТОЛПЫ КРИЧАТ
PLOHOYPAREN - Таблетка
rizza - плачь
fem.love - Фотографирую закат
АДЛИН - No Love
Korol i Shut - Кукла колдуна
Антон Токарев - Седьмой лепесток
Harry Styles - As It Was
MUPP - vendetta!
Нервы - Нервы
ANNA ASTI - По барам
Tom Odell - Another Love
